1
....#####.............
....#...#.............
....#...#.............
..###...###...........
..#.......#...........
###.#.###.#.....######
######################
#@$.................O#
######################
2
....#####.............
....#...#.............
....#...#.............
..###...###...........
..#.......#...........
###.#.###.#.....######
######################
#@$.................O#
######################
....#......###..######
....########..........
3
....#####.............
....#...#.............
....#...#.............
..###...###...........
..#.......#...........
###.#.###.#.....######
######################
#@$.................O#
######################
....#......###..######
....########..........
e
